Simple Maze:
#######
#A...B#
#.#.#.#
#.....#
#######

Medium Maze:
##########
#A......B#
#.#######.#
#.#.......#
#.#.#######
#.#........
###########

Complex Maze:
################
#A.......#....B#
#.####.#.#.###.#
#.#....#.#.....#
#.#.######.#####
#.#.............#
#.#.###########.#
#...............#
##################

